########
#    . #
# @$   #
#### ###
#    $ #
#  .   #
########
