#########
#@     ##
# # # # #
#  .$.  #
# #$#$# #
## .$.  #
# # # # #
##      #
#########
